1111111111111111111111111111111111111111111111111111111111111111111111111111111111111111111111111111111111111111111111111111111111111111111111111111111111111111111111111111111111111111111111111111111111111111111111111111111111111111111111111111111111111111111111111111111111111111111111111111111111111111111111111111111111111111111111111111111111111111111111111111111111111111111111111111111111111111111111111111111111111111111111111111111111111111111111111111111111111111111111111111111111111111111111111111111111111111111111111111
1E0000000000000C00000C0000000000011E0000000000000C00000C000000000001E0000000000000C00000C000000000001E0000000000000C00000C000000000001E0000000000000C00000C000000000001E0000000000000C00000C000000000001E0000000000000C00000C000000000001E0000000000000C00000C000000000001E0000000000000C00000C000000000001E0000000000000C00000C000000000001E0000000000000C00000C000000000001E0000000000000C00000C000000000001E0000000000000C00000C000000000001E0000000000000C00000C000000000001E0000000000000C00000C000000000001E0000000000000C00000C00000000000001
1010010100100000101001000000010101101001010010000010100100000001010101001010010000010100100000001010101001010010000010100100000001010101001010010000010100100000001010101001010010000010100100000001010101001010010000010100100000001010101001010010000010100100000001010101001010010000010100100000001010101001010010000010100100000001010101001010010000010100100000001010101001010010000010100100000001010101001010010000010100100000001010101001010010000010100100000001010101001010010000010100100000001010101001010010000010100100000001010001
1P0000000C00C0000000000000000000C11P0000000C00C0000000000000000000C1P0000000C00C0000000000000000000C1P0000000C00C0000000000000000000C1P0000000C00C0000000000000000000C1P0000000C00C0000000000000000000C1P0000000C00C0000000000000000000C1P0000000C00C0000000000000000000C1P0000000C00C0000000000000000000C1P0000000C00C0000000000000000000C1P0000000C00C0000000000000000000C1P0000000C00C0000000000000000000C1P0000000C00C0000000000000000000C1P0000000C00C0000000000000000000C1P0000000C00C0000000000000000000C1P0000000C00C0000000000000000000C001
1111111111111111111111111111111111111111111111111111111111111111111111111111111111111111111111111111111111111111111111111111111111111111111111111111111111111111111111111111111111111111111111111111111111111111111111111111111111111111111111111111111111111111111111111111111111111111111111111111111111111111111111111111111111111111111111111111111111111111111111111111111111111111111111111111111111111111111111111111111111111111111111111111111111111111111111111111111111111111111111111111111111111111111111111111111111111111111111111111