11111111111111111111111111111111111111111111
1E0000000000000C00000C0000000000000000000001
1010010100100000101001000P000101010000000001
10100100101010100010010000000101010000000001
10000000C00C0000000000000000000C100000000011
11111111111111111111111111111111111111111111